food	noun	category

fruit	noun	category
apple	noun	fruit
banana	noun	fruit
orange	noun	fruit

vegetable	noun	category
cabbage	noun	vegetable
potato	noun	vegetable
radish	noun	vegetable

furniture	noun	category
table	noun	furniture
bed	noun	furniture
chair	noun	furniture

cloth	noun	category
shirt	noun	cloth
pants	noun	cloth
skirt	noun	cloth
jacket	noun	cloth

am	verb	
are	verb	
is	verb	
find	verb	
want	verb	
buy	verb	
sell	verb	

large	adjective	size
small	adjective	size
long	adjective	length
short	adjective	length
hot	adjective	temperature
cold	adjective	temperature
red	adjective 	color
blue	adjective 	color
white	adjective 	color
yellow	adjective 	color
black	adjective 	color
green	adjective 	color
